NO ./textures/north.xpm
SO ./textures/south.xpm
WE ./textures/west.xpm
EA ./textures/east.xpm


F 58,52,60
C 34,30,44

111111111111111111111
1000000000000000000E1
111111111111111111111