NO ./textures/north.xpm
SO ./textures/south.xpm
WE ./textures/west.xpm
EA ./textures/east.xpm


F 58,52,60
C 34,30,44

111111111111111111111111111111111111111111111111111111111111111
100000000000000000000000000000000000000000000000000000000000011
1000000000N0000000000000000000000000000000000000000000000000011
111111111111111110000000111111111111111111111111111111111000111
111111111111111110000000111111111111111111111111111111111110111
111111000000000000000000000000000000000000000000000000000000011
111100000000000000000000000000000000000000000000000000000000011
111100000000000000000000000000000000000000000000000000001111111
111000000000000001000000100000000000100000000001000000001111111
111000000000000001000000100000000000100000000001000000001111111
111000000000000001000000100000000000100000000001000000001111111
111000000000000001000000100000000000100000000001000000001111111
111000000000000001000000100000000000100000000001000000001111111
111000000000000001000000100000000000100000000001000000001111111
111000000000000001000000100000000000100000000001000000001111111
111000000000000001000000100000000000100000000001000000001111111
111000000000000001000000100000000000100000000001000000001111111
111000000000000001000000100000000000100000000001000000001111111
100000000000000000000000000000000000000000000000000000000000011
100000000000000000000000000000000000000000000000000000000000011
100000000000000000000000000000000000000000000000000000000000011
100000000000011111111111111111111111111111111111110000000000011
100000000000000000000000000000000000000000000000000000000000011
100000000000000000000000000000000000000000000000000000000000011
111111111111111111111111111111111111111111111111111111111111111