NO ./textures/north.xpm
SO ./textures/south.xpm
WE ./textures/west.xpm
EA ./textures/east.xpm


F 58,52,60
C 34,30,44

1111111
1E11111
1111111